8 8 3
W......@
@@.@.@..
@.....@.
..@.@..@
.@...@.@
..@.@...
.@|@..@@
...@.... //end of first
@.......
..@@@@..
.@....@|
.@.W@..@
..@..@..
@..@@@..
.@..@..@
.@@...@. //end of second
W......@
@..@.@..
$@....@.
.@.@.@..
.@.@..@@
.@..@...
.@@@.@@.
........