50 50 3
@@@@@@@@@@@@@@@@@@@@@@@@@@@@@@@@@@@@@@@@@@@@@@@@@@
@W...............................................@
@.@@@@.@@@@.@@@@.@@@@.@@@@.@@@@.@@@@.@@@@.@@@@.@@@
@................................................@
@@@@.@@@@.@@@@.@@@@.@@@@.@@@@.@@@@.@@@@.@@@@.@@@@@
@................................................@
@.@@@@.@@@@.@@@@.@@@@.@@@@.@@@@.@@@@.@@@@.@@@@.@@@
@................................................@
@@@@.@@@@.@@@@.@@@@.@@@@.@@@@.@@@@.@@@@.@@@@.@@@@@
@@@@@@@@@@@@@@@@@@@@@@@@@@@@@@@@@@@@@@@.@@@@@....@
@................................................@
@.@@@@.@@@@.@@@@.@@@@.@@@@.@@@@.@@@@.@@@@.@@@@.@@@
@................................................@
@@@@.@@@@.@@@@.@@@@.@@@@.@@@@.@@@@.@@@@.@@@@.@@@@@
@................................................@
@.@@@@.@@@@.@@@@.@@@@.@@@@.@@@@.@@@@.@@@@.@@@@.@@@
@................................................@
@@@@.@@@@.@@@@.@@@@.@@@@.@@@@.@@@@.@@@@.@@@@.@@@@@
@................................................@
@....@@@@@@@@@@@@@@@@@@@@@@@@@@@@@@@@@@@@@@@@@@@.@
@................................................@
@.@@@@.@@@@.@@@@.@@@@.@@@@.@@@@.@@@@.@@@@.@@@@.@@@
@................................................@
@@@@.@@@@.@@@@.@@@@.@@@@.@@@@.@@@@.@@@@.@@@@.@@@@@
@................................................@
@.@@@@.@@@@.@@@@.@@@@.@@@@.@@@@.@@@@.@@@@.@@@@.@@@
@................................................@
@@@@.@@@@.@@@@.@@@@.@@@@.@@@@.@@@@.@@@@.@@@@.@@@@@
@................................................@
@@@@@@@@@@@@@@@@@@@@@@@@@@@@@@@@@@@@@@@@@@@@@....@
@................................................@
@.@@@@.@@@@.@@@@.@@@@.@@@@.@@@@.@@@@.@@@@.@@@@.@@@
@................................................@
@@@@.@@@@.@@@@.@@@@.@@@@.@@@@.@@@@.@@@@.@@@@.@@@@@
@................................................@
@.@@@@.@@@@.@@@@.@@@@.@@@@.@@@@.@@@@.@@@@.@@@@.@@@
@................................................@
@@@@.@@@@.@@@@.@@@@.@@@@.@@@@.@@@@.@@@@.@@@@.@@@@@
@................................................@
@....@@@@@@@@@@@@@@@@@@@@@@@@@@@@@@@@@@@@@@@@@@@@@
@................................................@
@.@@@@.@@@@.@@@@.@@@@.@@@@.@@@@.@@@@.@@@@.@@@@.@@@
@................................................@
@@@@.@@@@.@@@@.@@@@.@@@@.@@@@.@@@@.@@@@.@@@@.@@@@@
@................................................@
@.@@@@.@@@@.@@@@.@@@@.@@@@.@@@@.@@@@.@@@@.@@@@.@@@
@................................................@
@@@@.@@@@.@@@@.@@@@.@@@@.@@@@.@@@@.@@@@.@@@@.@@@@@
@...............................................|@
@@@@@@@@@@@@@@@@@@@@@@@@@@@@@@@@@@@@@@@@@@@@@@@@@@
@@@@@@@@@@@@@@@@@@@@@@@@@@@@@@@@@@@@@@@@@@@@@@@@@@
@|...............................................@
@.@@@@.@@@@.@@@@.@@@@.@@@@.@@@@.@@@@.@@@@.@@@@.@@@
@................................................@
@@@@.@@@@.@@@@.@@@@.@@@@.@@@@.@@@@.@@@@.@@@@.@@@@@
@................................................@
@.@@@@.@@@@.@@@@.@@@@.@@@@.@@@@.@@@@.@@@@.@@@@.@@@
@................................................@
@@@@.@@@@.@@@@.@@@@.@@@@.@@@@.@@@@.@@@@.@@@@.@@@@@
@@@@@@@@@@@@@@@@@@@@@@@@@@@@@@@@@@@@@@@@@@@@.....@
@................................................@
@.@@@@.@@@@.@@@@.@@@@.@@@@.@@@@.@@@@.@@@@.@@@@.@@@
@................................................@
@@@@.@@@@.@@@@.@@@@.@@@@.@@@@.@@@@.@@@@.@@@@.@@@@@
@................................................@
@.@@@@.@@@@.@@@@.@@@@.@@@@.@@@@.@@@@.@@@@.@@@@.@@@
@................................................@
@@@@.@@@@.@@@@.@@@@.@@@@.@@@@.@@@@.@@@@.@@@@.@@@@@
@................................................@
@....@@@@@@@@@@@@@@@@@@@@@@@@@@@@@@@@@@@@@@@@@@@@@
@................................................@
@.@@@@.@@@@.@@@@.@@@@.@@@@.@@@@.@@@@.@@@@.@@@@.@@@
@................................................@
@@@@.@@@@.@@@@.@@@@.@@@@.@@@@.@@@@.@@@@.@@@@.@@@@@
@................................................@
@.@@@@.@@@@.@@@@.@@@@.@@@@.@@@@.@@@@.@@@@.@@@@.@@@
@................................................@
@@@@.@@@@.@@@@.@@@@.@@@@.@@@@.@@@@.@@@@.@@@@.@@@@@
@................................................@
@@@@@@@@@@@@@@@@@@@@@@@@@@@@@@@@@@@@@@@@@@@@@....@
@................................................@
@.@@@@.@@@@.@@@@.@@@@.@@@@.@@@@.@@@@.@@@@.@@@@.@@@
@................................................@
@@@@.@@@@.@@@@.@@@@.@@@@.@@@@.@@@@.@@@@.@@@@.@@@@@
@................................................@
@.@@@@.@@@@.@@@@.@@@@.@@@@.@@@@.@@@@.@@@@.@@@@.@@@
@................................................@
@@@@.@@@@.@@@@.@@@@.@@@@.@@@@.@@@@.@@@@.@@@@.@@@@@
@................................................@
@....@@@@@@@@@@@@@@@@@@@@@@@@@@@@@@@@@@@@@@@@@@@@@
@................................................@
@.@@@@.@@@@.@@@@.@@@@.@@@@.@@@@.@@@@.@@@@.@@@@.@@@
@................................................@
@@@@.@@@@.@@@@.@@@@.@@@@.@@@@.@@@@.@@@@.@@@@.@@@@@
@................................................@
@.@@@@.@@@@.@@@@.@@@@.@@@@.@@@@.@@@@.@@@@.@@@@.@@@
@................................................@
@@@@.@@@@.@@@@.@@@@.@@@@.@@@@.@@@@.@@@@.@@@@.@@@@@
@...............................................W@
@@@@@@@@@@@@@@@@@@@@@@@@@@@@@@@@@@@@@@@@@@@@@@@@@@
@@@@@@@@@@@@@@@@@@@@@@@@@@@@@@@@@@@@@@@@@@@@@@@@@@
@W...............................................@
@.@@@@.@@@@.@@@@.@@@@.@@@@.@@@@.@@@@.@@@@.@@@@.@@@
@................................................@
@@@@.@@@@.@@@@.@@@@.@@@@.@@@@.@@@@.@@@@.@@@@.@@@@@
@................................................@
@.@@@@.@@@@.@@@@.@@@@.@@@@.@@@@.@@@@.@@@@.@@@@.@@@
@................................................@
@@@@.@@@@.@@@@.@@@@.@@@@.@@@@.@@@@.@@@@.@@@@.@@@@@
@@@@..@@@@@@@@@@@@@@@@@@@@@@@@@@@@@@@@@@@@@@@....@
@................................................@
@.@@@@.@@@@.@@@@.@@@@.@@@@.@@@@.@@@@.@@@@.@@@@.@@@
@................................................@
@@@@.@@@@.@@@@.@@@@.@@@@.@@@@.@@@@.@@@@.@@@@.@@@@@
@................................................@
@.@@@@.@@@@.@@@@.@@@@.@@@@.@@@@.@@@@.@@@@.@@@@.@@@
@................................................@
@@@@.@@@@.@@@@.@@@@.@@@@.@@@@.@@@@.@@@@.@@@@.@@@@@
@................................................@
@....@@@@@@@@@@@@@@@@@@@@@@@@@@@@@@@@@@@@@@@@@@@@@
@................................................@
@.@@@@.@@@@.@@@@.@@@@.@@@@.@@@@.@@@@.@@@@.@@@@.@@@
@................................................@
@@@@.@@@@.@@@@.@@@@.@@@@.@@@@.@@@@.@@@@.@@@@.@@@@@
@................................................@
@.@@@@.@@@@.@@@@.@@@@.@@@@.@@@@.@@@@.@@@@.@@@@.@@@
@................................................@
@@@@.@@@@.@@@@.@@@@.@@@@.@@@@.@@@@.@@@@.@@@@.@@@@@
@................................................@
@@@@@@@@@@@@@@@@@@@@@@@@@@@@@@@@@@@@@@@@@@@@@....@
@................................................@
@.@@@@.@@@@.@@@@.@@@@.@@@@.@@@@.@@@@.@@@@.@@@@.@@@
@................................................@
@@@@.@@@@.@@@@.@@@@.@@@@.@@@@.@@@@.@@@@.@@@@.@@@@@
@................................................@
@.@@@@.@@@@.@@@@.@@@@.@@@@.@@@@.@@@@.@@@@.@@@@.@@@
@................................................@
@@@@.@@@@.@@@@.@@@@.@@@@.@@@@.@@@@.@@@@.@@@@.@@@@@
@................................................@
@....@@@@@@@@@@@@@@@@@@@@@@@@@@@@@@@@@@@@@@@@@@@@@
@................................................@
@.@@@@.@@@@.@@@@.@@@@.@@@@.@@@@.@@@@.@@@@.@@@@.@@@
@................................................@
@@@@.@@@@.@@@@.@@@@.@@@@.@@@@.@@@@.@@@@.@@@@.@@@@@
@................................................@
@.@@@@.@@@@.@@@@.@@@@.@@@@.@@@@.@@@@.@@@@.@@@@.@@@
@................................................@
@@@@.@@@@.@@@@.@@@@.@@@@.@@@@.@@@@.@@@@.@@@@.@@@@@
@...............................................$@
@@@@@@@@@@@@@@@@@@@@@@@@@@@@@@@@@@@@@@@@@@@@@@@@@@