100 100 1
W.@@@@@@@@@@@@@@@@@@@@@@@@@@@@@@@@@@@@@@@@@@@@@@@@@@@@@@@@@@@@@@@@@@@@@@@@@@@@@@@@@@@@@@@@@@@@@@@@@@
..@...........@.....................................@...@...........................@...........@.@@
@.@..@@@.@@@@.@.@@@.@.@.@.@@.@@@@.@@@@@.@.@@@@@@.@@...@..@..@...@@@@@@@.@@@.@.@@@@@.@.@@...@.@@.@.@@
@.....@.........@.@.@...@.............@.@.....@...@.@.....@.@.@.........@...@.....@.....@.....@...@@
@.@@@.@.@@@.@@@@@.@.@..@@.@@@@@@.@@@@.@.@...@.@.@.@.@.@@@.@.@.@.@.@.@@@@@..@@@@...@.@@@..@@@@.@@..@@
@.....@.@.......@.@...@...@...@.....@.........@.@.@.....@...@.@.@.@.....@.....@.@...........@...@.@@
@@@@@@@@@.@@.@@...@@@@@.@@..@.@.....@..@@@@.@.@.@.@.@@@.@@..@.@.@.@@@@..@.@.@.@.@.@@@.@@@.@.@@@..@@@
@.........@.........@...@...@...@.@.@.....@.@...@.@.@...@.@...@.@...@.......@...@.@.......@...@...@@
@.@.@.@@.@@.@@.@.@......@.@.@.@@..@.@@....@.@.@.@...@.@@@.@@.@@.@@@.@.@.@@@.@.@.@.@@@.@.@@@.@@@@@.@@
@.@.@...@...@...@.....@.@.....@...@...@.....@.....@...@.........@...@.....@...@.@...@.@...........@@
@.@..@@.@@.@@...@@@@@@@@.@@.@.@.@@.@.@@.@@@@.@@...@.@@@.@@@.@@..@.@@@@@@...@@.@.@.@.@...@.@.@.@@@.@@
@.....@.......@...@.......@.@...@.....@...@...@.@.@...@.@.@.@...@.......@...@.@...@.@...@..........@
@@@@@...@@.@@@@@@.@.@.@@@.@.@.@@@..@@.@@@.@.@.@@@.@.@...@.@.@@@@@...@.@.@@@.@.@.@@@.@.@.@@@.@.@.@.@@
@...@.@.........@.@.....@.@.......@.@...@...@.....@.@.@.@.@.......@.@.....@.....@...@.@.....@.@...@@
@...@.@@@.@...@.@.@@..@.@.@.@@..@.@.@@@.@.@@@@@@@@@...@.@.@@@.@.@@@.@@...@@.@.@.@.@@..@.@@@.@.@@@@.@
@.@.@.....@.@.@.........@...@.........@.....@.....@.@...@...@...@.@.....@.............@.....@.....@@
@@..@@@.@.@.@.@@@@@@@@@@@@.@@.@.@.@@@.@.@@@.@@.@@.@.@@.@@@@.@@.@@.@.@...@.@.@.@@..@@@@@.@@@.@@@@@.@@
@...@...@...@.....@...........@.......@...@.......@...........@...........@.@.@.......@...@.......@@
@.@@@.@@@..@.@@@@.@.@.@@@@@...@.@.@@...@..@.@@@..@@@@@@@@...@...@..@@...@.@.....@@.@@.@.@.@@@@.@@..@
@.@...@...@.....@...@.......@.....@.....@.@.................@...@.....@.@.@.@.@.@.@...@.@.....@...@@
@...@@.@@.@..@@.@.@@..@...@@..@...@.@@@...@@@.@@@.@..@@.@.@.@@@@@.@.@@@.@.@.....@.@.@.@...@@@.@.@.@@
@.@.........@.........@...@...@.@.@...@.@.@...@...@.....@.@.....@.@.....@.@.....@.......@...@......@
@..@@@@.@@@.@@@.@@@@@.@.@.@..@@@@..@@...@...@@@.@@@.@..@..@.@@@@@.@@..@.@.@.@@@@@.@@@.@@@..@@@@@.@.@
@.....@...@.........@.@.@.@.......@...@.@.......@...@.........@...@...@.@.....@...@...............@@
@.@@@.@.@.@@..@@@@..@.@.@...@...@@@.@@@.@@@@....@.@@.@@@@@@.@.@.@@@.@.@.@.@.@.@..@@.@.@.@@@@@@.@@.@@
@.@...........@...@.....@...@.@.@.......@...@.@.............@.@...@...@.....@...@...@...@.....@...@@
@.@...@@.@@..@..@....@.@@.@@@.@.@@@.@..@@.@...@.@@@.@.@@@.@.@.@@@...@@@..@..@.@@.@@.@.@.@@@@@.@.@.@@
@...@.......@.........@...@...@...@.....@.@...@.@...@.@...@.@.@...@.....@.@.@.....@...@.......@.@.@@
@.@.@@@@.@..@@@.@@..@.@.@..@@@@.@.@.@.@@@...@.@.@@@.@.@.@@@.@...@....@@@@...@@@@@.@@@@@.@.@@@.@.@@.@
@...@.......@.......@...@.......@.........@...@...@.@.............@.@.....@.......@.......@...@...@@
@.@.@..@.@@.@.@.@.@@@@@.@@@.@..@@.@@@.@.@@@@@@@@..@.@@@...@@@@@@@...@.@@@.@@@.@.@@@.@@@@@@@@@@@@@..@
@.@...........@.@...@.....@.@.....@.@.@...........@.@...@.........@.@...@.......@.@.@..............@
@..@.@..@@@..@@..@@.@@@.@.@.@@@@@@@.@.@@@@.@@@@@@@@.@.@.@@@@@@@@.@...@@@.@@@@.@.@.@....@@@@@@..@@.@@
@.............@.@.........@.@.....@.......@.@.........@.....@.....@...........@.@...@.@.......@...@@
@..@@@@.@@@@@.@.@.@@@@@@..@.@.@@@.@.@...@...@.@@@@@@@.@.@@@@..@@..@.@..@@@@.@.@.@@@@@.@.@.@@@.@..@@@
@...@.....@.......@.....@...@.@.....@...@.@.........@.@.@.......@.@...@.............@...@...@.@...@@
@.@...@.@.@.@.@.@.@.@...@@@@@.@.@@.@@@@.@.@.@@.@...@....@.@@@...@.@@@@..@..@.@@@@.@..@@.@.@.@.@@@..@
@...@.@.@...@...@...@.@.......@.@.@.....@...@.....@...@...@...@.........@.@.......@.@..............@
@@....@..@@@@@@.@@@.@.@@@.@.@.@.@.@..@@..@@.@.@@@@@..@..@@..@.@.@@@@@.@@..@.@@@.@@@.@.@@@.@@@@@.@.@@
@.....@.@...@...@...@.........@.@.@...@.....@.@.....@.......@.@...@...@...@.......@...@.....@...@.@@
@.@@@.@.@.@..@.@@.@@.@@.@@@.@...@.@@@.@....@@.@.@.@.@..@@@@@@.@@..@@..@.@@..@.@@@...@@@.@@@.@.@.@.@@
@.@...@...@...................@.@.....@...........@.............@...@.......@.@.....@.......@.@...@@
@.@.@.@@@.@@.@@@@@.@.@..@.@@@.@..@..@.@.@.@.@@@.@@@.@@@.@..@@@@.@.@.@@@@@@.@@.@...@...@.@.@.@.@.@@@@
@...@...@.......@...@.....@...@.@.......@.@.....@...@.....@.....@.@.................@...@.@...@.@.@@
@.@@.@@.@@.@@.@@@.@...@@@@@@@.......@@.@@.@@@@@.@.@@.@@@@.@@@.@@.@.@@.@.@@@.@.@@@@@.@@..@.@.@.@.@.@@
@.@.....@.@...@...@.@.........@...@.........@...@...@...@...@...........@.....@.....@...@.....@...@@
@@..@@@@@.@.@@@.@@@.@@@.@@@@@@@@@.@.@@@.@@@.@.@@......@.@@@.@.@@..@@@@..@.@...@.@.@@..@@.@@@@.@@@.@@
@...........@...@.@...@.............@...@.@.....@.@...@...@.............@.@.....@.@.........@...@.@@
@.@@@@.@@@@.@.@@@.@.@.@@@.@@@@@.@@@@@.@@@.@@@@@..@@.@@@@..@@@.@@@@@@@..@@.@.@.@@..@.@...@@..@@..@.@@
@.........@.@.......@...@...@...@.....@.......@.........@...@...........@.@...@...@.....@.@...@.@.@@
@.@@@@@@..@@@..@@@@..@..@@@.@...@.@@@.@.@.@@@.@.@.@@@@@.@@@.@.@..@..@.@.@.@@@@@@@@..@.@@@.@.@@..@.@@
@.....@...@.........@...@...@.@.@.@...@.@.......@.....@.@.....@.......@.@.........@.........@......@
@.@.@@..@.@.@@@.@@@.@..@@@..@.@.@..@..@.@@.@@@@.@.@...@.@.@.@.@.@.@.@.@@@@...@@@@.@@@@@.@@@@@...@.@@
@...@...@.....@...@.@.....@...@.@.@...@.......@.@...@.@.@.@.....@.@.@.....@.....@...@...@.....@.@.@@
@.@@@.@.@@@.@.@.@..@.@@@@.@@@.@@..@.@@.@@@..@@@.@.@@....@.@.@@@@@.@.@.@@@.@@..@.@.@.@.@@@.@.@@@@@.@@
@.............@.@.....@...@...@...@.........@.........@.......@...@.....@.....@...@.@...@.@.@......@
@@@.@@@@.@.@.@@.@@.@@...@@@..@@.@.@@@@@@@@@@@.@@@.@.@.@.@@@@@@@.@@@.@@@.@@@@@@@.@@@@@@@...@@@.@.@@@@
@.......@...@...@...@...@.....................@.......@.@.......@.....@.........@.......@.@...@...@@
@.@...@.@.@.@.@@@.@@@.@@@.@@@@.@.@.@@@@@@@.@..@.@.@@@@@@@.@@@@@@@..@@.@@@@@@@@@@@..@.@@@@.@.@@..@.@@
@.@...@.@.@.@...@.@...........@...@.........@.@...@.......@.....@.@.......................@...@.@.@@
@.@@@.@...@@.@@.@...@@@@@..@@...@.@...@@@@..@.@@@.@@@@@..@@.@.@.@.@..@@@@.@@@@@.@.@.@.@@@.@@@.@.@.@@
@.....@.........@.@...@.@.......@...........@.@.@.......@.....@.@.@.........@.......@.....@.@...@.@@
@.@.@.@...@.@@@.@.@...@.@.@..@.@@...@@@.@@.@....@..@@@@@@@@@.@@.@.@.@.@..@@...@.@@@.@.@@@.@.@...@..@
@.@.@.@...@...@.........@.@.....@.....@...........@.............@...@.@...@...@.@...@...@...@......@
@.@..@@@@..@@.@@@@@@@@@.@..@@.@.@@@.@.@@@..@@.@.@.@..@@.@...@@@.@@..@.@@@.@@..@.@@.@@@........@...@@
@.@.......@.@.......@...@.....@.....@...........@.@...@.@.@.@.@...@.........@.....@.........@.....@@
@.@@.@@@@@....@@@.@.@@@.@.@@@@.@@@@.@@@.@@@......@@.@...@.@.@.@@@.@.@@@@@.@.@.@@..@..@@......@.@@.@@
@.......@...@...@.@...@.....@.....@.@.....@.@.@...@.@...@...@.@...@.@...@.@.@...@.@...@.........@.@@
@@.@@@@.@.@...@.@@@@..@.@@@.@...@@@.@...@@@.@.@...@.@.@@@@@@@.@..@..@.@.@.@.@.@@..@@@..@..@.@@.@@.@@
@.@.....@.@...@.....@.@.@...........@.@.....@.....@.@.............@.........@.....@...@...@.....@.@@
@.@...@..@@.@.@.@@@...@.@.@@@@@.@@@@..@.@..@.@....@.@.@.@.@.@@@@.@@@@@@.@.@@..@.@.@.@@@.@@..@@..@.@@
@...@.........@.......@.@...........@.@.@.@.....@...@...@.@...........@.@.....@...@.....@.........@@
@@@@@@@@.@@@@.@..@@@@@@..@@.@@@.@.@.@.@@@.@@@@@..@..@.@.@@@.@@@...@...@.@@@.@@@@@.@.@.@@....@..@@@@@
@...@.........@.......@...@.....@...@...@.....@.......@.....@.......@.@...@.@.....@.........@.....@@
@...@.@..@@@@...@@@.@.@..@..@...@.@@@@@.@@@@@.@.@@.@@@@.@.@@..@.@@.@@@.@@.@.@.@.@...@...@.@@@.@@..@@
@.@...@.@.....@...@.@...@.....@.@...........@.@.....@...@...@...@.........@...@.@.....@.@.....@...@@
@.@@@@@.@.@@.@@.@...@.@.@.@@@@@.@@@.@@@@@.....@.@.....@@@...@.@@@.@@@@@.@...@@@.@@@.@.@.@@@..@@...@@
@...@...@.@.@...@...@.@...........@...@...@.@.@.@...@.@...@.......@...@.@.@.@.......@.@.@...@...@.@@
@.@.@.@@@.@.@.@.@.@.@.@..@@@.@@@@.@.@...@...@..@..@.@...@.@.@.....@@..@.@...@@@@@@@@..@.@.@.@.@@@..@
@...........@.....@...............@.@...@.@.@.....@...@.@.@.@.@.....@.@...@...............@........@
@@..@@@.@@@@@.@@.@@@@@..@@.@@@@.@.@.@@@@@.@@@@@.@.@..@....@.@@@@@@..@.@@@@@..@@@@@@@@@@.@.@.@@@.@@@@
@...@.............@...@.....@.....@...@.......@.....@.@...@...............@...@...@.........@.@....@
@..@@.@@@.@@@@@@..@@..@.@@@..@.@@.@@@.@@.@@@..@.@.....@@@..@@@@@@.@.@.@@@...@.@.@.@.@@@@@.@@..@@@.@@
@...............@.....@...@...@.......@...@...@.@.........@...@...@...@.@.@.@...@.......@.@.....@..@
@..@..@@@@@@..@..@@@..@@@.@@@...@..@@.@.@.@@@.@.@@..@@@@@.@...@.@.@@.@@.@.@.@.@@..@@@.@.@.@...@...@@
@.............@...@.@.@.@.@.@.@.@.@.....@.......@...@.....@...@.......@.......@.@.@...@.@.....@.@.@@
@.@..@@@@@@@@@@@..@.@.@.@.@.@.@.@.@.@@@@@@@.@@@.@.@.@.@.@.@@@.@@@.@@@.@.@@@@@.@.@.@...@...@@@.@@..@@
@...@.............@...............@.@.....@...@.....@.@.@.......@.@...@.........@.@.....@.@...@...@@
@..@.@@.@@@@@@@....@@@@@@.@.@@@@@@...@@@@..@@.@@@@..@.@.@@@@@@@.@.@.@@@@.@@.@@@...@..@..@@@.@.@.@@.@
@...........@...@...........@.......@.......@...@...@.@...........@...@.........@.@.......@...@.@.@@
@.@.@.@@@@..@.@.@@@.@@@.@.@.@...@@.@@.@@@@@.@@@.@.@...@@@@.@@@@@.@.@@.@.@.@@@@@.@.@.@.@@@.@.@.@.@.@@
@.@...@...@.@.@.............@.@...@.......@...@.@.....@...........@.....@.....@.....@...@.@.@.....@@
@.@.@@@.@.@.@.@.@.@.@@@@@@@.@.@.@.@.@@@@@.@@@.@...@@@@@@@.....@@@.@.@...@.@.@.@.@@@.@@@@..@.@@@@@.@@
@.....@.@...@.@.@.@.@.......@...@.......@.....@...@.......@.@.......@.@.@.....@...@.....@.@.@.....@@
@@@.@....@@@@.@...@.@.@@@@@..@@@@@@@.@@.@.@@@...@....@..@@@.@.@.@@.@@.@.....@@@@@.@.@@..@.@.@.@@..@@
@...@...@.....@.@.@.......@.........@...@...@.@...@.@.@.....@.@.........@...............@.@.......@@
@.@@@.@@@.@@@@@...@@.@......@@@@@@@.@...@@@.@.@@@@..@.@.@@@@..@@@@@@@.@.@@@@.@@...@.@@@@@.@.@@@.@@@@
@...............@.................@.........@.......@...............@...........@.........@........@
@@@@@@@.@@@@@@@@@@@@@@@.@@@@@@@@@@@@@@@@@@.@@@@@@@.@@@@@.@@@@@@.@@@@@@.@.@@@@@@@.@@@@.@@@@@@@.@.@...
@@@@@@@@@@@@@@@@@@@@@@@@@@@@@@@@@@@@@@@@@@@@@@@@@@@@@@@@@@@@@@@@@@@@@@@@@@@@@@@@@@@@@@@@@@@@@@@@@@.$